4/4
0/0/16777160/2/1/1/0/0/0/0/0/0/0/0/0/0/0/0
0/1/4177727/1/1/1/0/0/0/0/0/0/0/0/0/0/0/0
0/2/16777160/2/1/1/0/0/0/0/0/0/0/0/0/0/0/0
0/3/4177727/1/1/1/0/0/0/0/0/0/0/0/0/0/0/0
1/0/4177727/1/1/1/0/0/0/0/0/0/0/0/0/0/0/0
1/1/16777160/2/1/1/0/0/0/0/0/0/0/0/0/0/0/0
1/2/4177727/1/1/1/0/0/0/0/0/0/0/0/0/0/0/0
1/3/16777160/2/1/1/0/0/0/0/0/0/0/0/0/0/0/0
2/0/16777160/2/1/1/0/0/0/0/0/0/0/0/0/0/0/0
2/1/16777160/2/1/1/0/0/0/0/1/1/0/0/0/0/0/0
2/2/16777160/2/1/1/0/0/0/0/0/0/0/0/0/0/0/0
2/3/16777160/2/1/1/0/0/0/0/1/1/0/0/0/0/0/0
3/0/16777160/2/1/1/0/0/0/0/1/1/0/0/0/0/0/0
3/1/16777160/2/1/1/0/0/0/0/0/0/0/0/0/0/0/0
3/2/16777160/2/1/1/0/0/0/0/1/1/0/0/0/0/0/0
3/3/16777160/2/1/1/0/0/0/0/0/0/0/0/0/0/0/0
